1 1 1 1 1 1 1 1 1 1 1 1 1 1 10
1 0 4 4 4 0 0 0 0 0 0 0 0 0 1
1 0 4 8 0 0 0 0 0 0 0 0 0 0 1
1 0 4 4 4 3 12 10 11 0 0 0 11 10 1
1 0 0 0 0 0 0 0 0 0 0 0 0 0 1
1 0 0 0 0 0 0 0 0 0 0 0 0 0 1
1 10 11 12 4 4 4 4 4 2 2 2 2 2 1
1 0 0 0 0 0 0 0 0 0 0 0 0 0 1
1 0 0 5 0 s 0 2 0 12 0 0 0 0 1
1 0 0 0 0 3 10 9 0 0 0 0 0 0 1
1 0 0 0 0 0 0 0 0 0 0 0 0 0 1
1 1 5 5 5 13 10 11 11 3 0 0 0 0 1
1 1 10 7 0 0 0 0 0 3 0 0 0 0 1
1 0 0 0 /n 0 0 0 0 0 0 0 0 0 1
1 0 0 s 0 10 0 10 0 0 1 1 1 1 10
1 0 4 4 4 0 0 0 0 0 0 0 0 0 1
1 0 4 8 0 0 0 0 0 0 0 0 0 0 1
1 0 4 4 4 3 12 10 11 0 0 0 11 10 1
1 0 0 0 0 0 0 0 0 0 0 0 0 0 1
1 0 0 0 0 0 0 0 0 0 0 0 0 0 1
1 10 11 12 4 4 4 4 4 2 2 2 2 2 1
1 0 0 0 0 0 0 0 0 0 0 0 0 0 1
1 0 0 5 0 s 0 2 0 12 0 0 0 0 1
1 0 0 0 0 3 10 9 0 0 0 0 0 0 1
1 0 0 0 0 0 0 0 0 0 0 0 0 0 1
1 1 5 5 5 13 10 11 11 3 0 0 0 0 1
1 1 10 7 0 0 0 0 0 3 0 0 0 0 1
1 1 1 1 1 1 1 1 1 1 1 1 1 1 1